73 73 73 73 73 73 73 73 73 73 73 73 73 73 73 73 73 73 73 73 73 73 73 73 73 73 73 73
73 73 73 73 73 73 73 73 73 73 73 73 73 73 73 73 73 73 73 73 73 73 73 73 73 73 73 73
03 12 12 12 12 12 12 12 12 12 12 12 12 12 12 12 12 12 12 12 12 12 12 12 12 12 12 02
13 73 73 73 73 73 73 73 73 73 73 73 73 73 73 73 73 73 73 73 73 73 73 73 73 73 73 11
13 73 33 40 40 40 40 40 40 40 40 32 73 33 32 73 33 40 40 40 40 40 40 40 40 32 73 11
13 73 30 42 42 42 42 52 53 42 42 31 73 41 43 73 30 42 42 52 53 42 42 42 42 31 73 11
13 73 73 73 73 73 73 41 43 73 73 73 73 41 43 73 73 73 73 41 43 73 73 73 73 73 73 11
20 40 32 73 33 32 73 41 43 73 33 40 40 51 50 40 40 32 73 41 43 73 33 32 73 33 40 25
21 42 31 73 41 43 73 30 31 73 30 42 42 42 42 42 42 31 73 30 31 73 41 43 73 30 42 24
13 73 73 73 41 43 73 73 73 73 73 73 73 73 73 73 73 73 73 73 73 73 41 43 73 73 73 11
13 73 33 40 51 43 73 33 40 40 40 32 74 33 32 74 33 40 40 40 32 73 41 50 40 32 73 11
13 73 30 42 42 31 73 30 42 42 42 31 73 41 43 73 30 42 42 42 31 73 30 42 42 31 73 11
13 73 73 73 73 73 73 73 73 73 73 73 73 41 43 73 73 73 73 73 73 73 73 73 73 73 73 11
00 10 10 10 10 32 73 33 32 73 33 40 40 51 50 40 40 32 73 33 32 73 33 10 10 10 10 01
73 73 73 73 73 13 73 41 43 73 30 42 42 42 42 42 42 31 73 41 43 73 11 73 73 73 73 73
73 73 73 73 73 13 73 41 43 73 73 73 73 73 73 73 73 73 73 41 43 73 11 73 73 73 73 73
73 73 73 73 73 13 73 41 43 73 63 10 10 10 10 10 10 62 73 41 43 73 11 73 73 73 73 73
12 12 12 12 12 31 73 30 31 73 11 73 73 73 73 73 73 13 73 30 31 73 30 12 12 12 12 12
75 75 75 75 75 75 73 73 73 73 11 73 73 73 73 73 73 13 73 73 73 73 75 75 75 75 75 75
10 10 10 10 10 32 73 33 32 73 11 73 73 73 73 73 73 13 73 33 32 73 33 10 10 10 10 10
73 73 73 73 73 13 73 41 43 73 60 12 71 72 72 70 12 61 73 41 43 73 11 73 73 73 73 73
73 73 73 73 73 13 73 41 43 73 73 73 73 73 73 73 73 73 73 41 43 73 11 73 73 73 73 73
73 73 73 73 73 13 73 41 50 40 40 32 74 33 32 74 33 40 40 51 43 73 11 73 73 73 73 73
03 12 12 12 12 31 73 41 53 42 42 31 73 41 43 73 30 42 42 52 43 73 30 12 12 12 12 02
13 73 73 73 73 73 73 41 43 73 73 73 73 41 43 73 73 73 73 41 43 73 73 73 73 73 73 11
13 73 33 40 40 32 73 41 43 73 33 40 40 51 50 40 40 32 73 41 43 73 33 40 40 32 73 11
13 73 30 42 42 31 73 30 31 73 30 42 42 42 42 42 42 31 73 30 31 73 30 42 42 31 73 11
13 73 73 73 73 73 73 73 73 73 73 73 73 73 73 73 73 73 73 73 73 73 73 73 73 73 73 11
13 73 33 40 40 32 73 33 40 40 40 32 73 33 32 73 33 40 40 40 32 73 33 40 40 32 73 11
13 73 41 73 73 43 73 41 73 73 73 43 73 41 43 73 41 73 73 73 43 73 41 73 73 43 73 11
13 73 30 42 42 31 73 30 42 42 42 31 73 41 43 73 30 42 42 42 31 73 30 42 42 31 73 11
13 73 73 73 73 73 73 73 73 73 73 73 73 41 43 73 73 73 73 73 73 73 73 73 73 73 73 11
00 10 10 10 10 10 10 10 10 10 10 10 10 22 23 10 10 10 10 10 10 10 10 10 10 10 10 01
73 73 73 73 73 73 73 73 73 73 73 73 73 73 73 73 73 73 73 73 73 73 73 73 73 73 73 73
73 73 73 73 73 73 73 73 73 73 73 73 73 73 73 73 73 73 73 73 73 73 73 73 73 73 73 73
73 73 73 73 73 73 73 73 73 73 73 73 73 73 73 73 73 73 73 73 73 73 73 73 73 73 73 73
0 0 0 0 0 0 0 0 0 0 0 0 0 0 0 0 0 0 0 0 0 0 0 0 0 0 0 0
0 0 0 0 0 0 0 0 0 0 0 0 0 0 0 0 0 0 0 0 0 0 0 0 0 0 0 0
0 0 0 0 0 0 0 0 0 0 0 0 0 0 0 0 0 0 0 0 0 0 0 0 0 0 0 0
0 1 1 1 1 1 1 1 1 1 1 1 1 1 1 1 1 1 1 1 1 1 1 1 1 1 1 0
0 1 0 0 0 0 0 0 0 0 0 0 1 0 0 1 0 0 0 0 0 0 0 0 0 0 1 0
0 1 0 0 0 0 0 0 0 0 0 0 1 0 0 1 0 0 0 0 0 0 0 0 0 0 1 0
0 1 1 1 1 1 1 0 0 1 1 1 1 0 0 1 1 1 1 0 0 1 1 1 1 1 1 0
0 0 0 1 0 0 1 0 0 1 0 0 0 0 0 0 0 0 1 0 0 1 0 0 1 0 0 0
0 0 0 1 0 0 1 0 0 1 0 0 0 0 0 0 0 0 1 0 0 1 0 0 1 0 0 0
0 2 1 1 0 0 1 1 1 1 1 1 1 0 0 1 1 1 1 1 1 1 0 0 1 1 2 0
0 1 0 0 0 0 1 0 0 0 0 0 1 0 0 1 0 0 0 0 0 1 0 0 0 0 1 0
0 1 0 0 0 0 1 0 0 0 0 0 1 0 0 1 0 0 0 0 0 1 0 0 0 0 1 0
0 1 1 1 1 1 1 1 1 1 1 1 1 0 0 1 1 1 1 1 1 1 1 1 1 1 1 0
0 0 0 0 0 0 1 0 0 0 0 0 0 0 0 0 0 0 0 0 0 1 0 0 0 0 0 0
0 0 0 0 0 0 1 0 0 0 0 0 0 0 0 0 0 0 0 0 0 1 0 0 0 0 0 0
0 0 0 0 0 0 1 0 0 0 0 0 0 0 0 0 0 0 0 0 0 1 0 0 0 0 0 0
0 0 0 0 0 0 1 0 0 0 0 0 0 0 0 0 0 0 0 0 0 1 0 0 0 0 0 0
0 0 0 0 0 0 1 0 0 0 0 0 0 0 0 0 0 0 0 0 0 1 0 0 0 0 0 0
0 0 0 0 0 0 1 0 0 0 0 0 0 0 0 0 0 0 0 0 0 1 0 0 0 0 0 0
0 0 0 0 0 0 1 0 0 0 0 0 0 0 0 0 0 0 0 0 0 1 0 0 0 0 0 0
0 0 0 0 0 0 1 0 0 0 0 0 0 0 0 0 0 0 0 0 0 1 0 0 0 0 0 0
0 0 0 0 0 0 1 0 0 0 0 0 0 0 0 0 0 0 0 0 0 1 0 0 0 0 0 0
0 0 0 0 0 0 1 0 0 0 0 0 0 0 0 0 0 0 0 0 0 1 0 0 0 0 0 0
0 0 0 0 0 0 1 0 0 0 0 0 0 0 0 0 0 0 0 0 0 1 0 0 0 0 0 0
0 1 1 1 1 1 1 0 0 1 1 1 1 0 0 1 1 1 1 0 0 1 1 1 1 1 1 0
0 1 0 0 0 0 1 0 0 1 0 0 0 0 0 0 0 0 1 0 0 1 0 0 0 0 1 0
0 1 0 0 0 0 1 0 0 1 0 0 0 0 0 0 0 0 1 0 0 1 0 0 0 0 1 0
0 1 1 1 1 1 1 1 1 1 1 1 1 1 1 1 1 1 1 1 1 1 1 1 1 1 1 0
0 1 0 0 0 0 1 0 0 0 0 0 1 0 0 1 0 0 0 0 0 1 0 0 0 0 1 0
0 2 0 0 0 0 1 0 0 0 0 0 1 0 0 1 0 0 0 0 0 1 0 0 0 0 2 0
0 1 0 0 0 0 1 0 0 0 0 0 1 0 0 1 0 0 0 0 0 1 0 0 0 0 1 0
0 1 1 1 1 1 1 1 1 1 1 1 1 0 0 1 1 1 1 1 1 1 1 1 1 1 1 0
0 0 0 0 0 0 0 0 0 0 0 0 0 0 0 0 0 0 0 0 0 0 0 0 0 0 0 0
0 0 0 0 0 0 0 0 0 0 0 0 0 0 0 0 0 0 0 0 0 0 0 0 0 0 0 0
0 0 0 0 0 0 0 0 0 0 0 0 0 0 0 0 0 0 0 0 0 0 0 0 0 0 0 0
0 0 0 0 0 0 0 0 0 0 0 0 0 0 0 0 0 0 0 0 0 0 0 0 0 0 0 0